NO ./textures/eagle.xpm
SO ./textures/purplestone.xpm
WE ./textures/greystone.xpm
EA ./textures/redbrick.xpm
F 220,    100,     0
C      225 , 30,0 


11111
10001
10001
1N001
11111
