NO ./textures/eagle.xpm
SO ./textures/purplestone.xpm
WE ./textures/greystone.xpm
EA ./textures/redbrick.xpm
F 220,    100,     0
C      225 , 30,0 


11111111
100000001
10010001
1N000001
10010001
10010001
10010001
10010001
10010001
10010001
1111111
